GENE_EXON_REGION_DIR	/rgs01/project_space/zhanggrp/MethodDevelopment/common/CiceroPaper/software/Cicero/0.1.0/reference/Homo_sapiens/GRCh37-lite/REGIONS/GENE_EXON_REGION
TWOBIT	/rgs01/project_space/zhanggrp/MethodDevelopment/common/CiceroPaper/software/Cicero/0.1.0/reference/Homo_sapiens/GRCh37-lite/2BIT/GRCh37-lite.2bit
COMBINED_REFFLAT	/rgs01/project_space/zhanggrp/MethodDevelopment/common/CiceroPaper/software/Cicero/0.1.0/reference/Homo_sapiens/GRCh37-lite/mRNA/Combined/all_refFlats.txt
FASTA_CHR	/rgs01/project_space/zhanggrp/MethodDevelopment/common/CiceroPaper/software/Cicero/0.1.0/reference/Homo_sapiens/GRCh37-lite/FASTA/chromosomes
FASTA	/rgs01/project_space/zhanggrp/MethodDevelopment/common/CiceroPaper/software/Cicero/0.1.0/reference/Homo_sapiens/GRCh37-lite/FASTA/GRCh37-lite.fa
REFSEQ_REFFLAT	/rgs01/project_space/zhanggrp/MethodDevelopment/common/CiceroPaper/software/Cicero/0.1.0/reference/Homo_sapiens/GRCh37-lite/mRNA/RefSeq/refFlat-sharp.txt
BLACKLIST_GENES	/rgs01/project_space/zhanggrp/MethodDevelopment/common/CiceroPaper/software/Cicero/0.1.0/reference/Homo_sapiens/GRCh37-lite/CICERO/blacklist.genes.txt
BLACKLIST_FUSIONS	/rgs01/project_space/zhanggrp/MethodDevelopment/common/CiceroPaper/software/Cicero/0.1.0/reference/Homo_sapiens/GRCh37-lite/CICERO/blacklist.fusions.txt
EXCLD_CHR	M,Y,GL,HAP
REFGENE2PROTEIN	/rgs01/project_space/zhanggrp/MethodDevelopment/common/CiceroPaper/software/Cicero/0.1.0/reference/Homo_sapiens/GRCh37-lite/CICERO/refgene2protein.tab
CHR_LENGTHS	/rgs01/project_space/zhanggrp/MethodDevelopment/common/CiceroPaper/software/Cicero/0.1.0/reference/Homo_sapiens/GRCh37-lite/SUPPORT/chromosome_lengths.txt
COMPLEX_REGIONS	/rgs01/project_space/zhanggrp/MethodDevelopment/common/CiceroPaper/software/Cicero/0.1.0/reference/Homo_sapiens/GRCh37-lite/CICERO/complex_regions.txt
KNOWN_FUSIONS	/rgs01/project_space/zhanggrp/MethodDevelopment/common/CiceroPaper/software/Cicero/0.1.0/reference/Homo_sapiens/GRCh37-lite/CICERO/known_fusions.txt
KNOWN_ITD_FILE	/rgs01/project_space/zhanggrp/MethodDevelopment/common/CiceroPaper/software/Cicero/0.1.0/reference/Homo_sapiens/GRCh37-lite/CICERO/known_ITDs.txt
CLINCLS_GOLD_GENE_LIST_FILE	/rgs01/project_space/zhanggrp/MethodDevelopment/common/CiceroPaper/software/Cicero/0.1.0/reference/Homo_sapiens/GRCh37-lite/CLINICAL/MEDAL_CONFIG/GoldGene.lst
	
BLAT_HOST	localhost
BLAT_PORT	9000
	
MAX_NUM_HITS	
MIN_FUSION_DIST	
MIN_HIT_LEN	
MIN_SC_LEN	
MIN_SC_READS	
	
